#######################################
# Syntax Coloring Map For DuppaLibrary
#######################################

#######################################
# Datatypes (KEYWORD1)
#######################################

i2cEncoderLibV2	KEYWORD1	i2cEncoderLibV2

#######################################
# Methods and Functions (KEYWORD2)
#######################################

begin	KEYWORD2
reset	KEYWORD2
attachInterrupt	KEYWORD2
deattachInterrupt	KEYWORD2
autoconfigInterrupt	KEYWORD2
readGP1conf	KEYWORD2
readGP2conf	KEYWORD2
readGP3conf	KEYWORD2
readInterruptConfig	KEYWORD2
updateStatus	KEYWORD2
readStatus	KEYWORD2
readInt2	KEYWORD2
readFadeStatus	KEYWORD2
readCounterFloat	KEYWORD2
readCounterLong	KEYWORD2
readCounterInt	KEYWORD2
readCounterByte	KEYWORD2
readMax	KEYWORD2
readMaxFloat	KEYWORD2
readMin	KEYWORD2
readMinFloat	KEYWORD2
readStep	KEYWORD2
readStepFloat	KEYWORD2
readLEDR	KEYWORD2
readLEDG	KEYWORD2
readLEDB	KEYWORD2
readGP1	KEYWORD2
readGP2	KEYWORD2
readGP3	KEYWORD2
readAntibouncingPeriod	KEYWORD2
readDoublePushPeriod	KEYWORD2
readFadeRGB	KEYWORD2
readFadeGP	KEYWORD2
readEEPROM	KEYWORD2
writeGP1conf	KEYWORD2
writeGP2conf	KEYWORD2
writeGP3conf	KEYWORD2
writeInterruptConfig	KEYWORD2
writeCounter	KEYWORD2
writeMax	KEYWORD2
writeMin	KEYWORD2
writeStep	KEYWORD2
writeLEDR	KEYWORD2
writeLEDG	KEYWORD2
writeLEDB	KEYWORD2
writeRGBCode	KEYWORD2
writeGP1	KEYWORD2
writeGP2	KEYWORD2
writeGP3	KEYWORD2
writeAntibouncingPeriod	KEYWORD2
writeDoublePushPeriod	KEYWORD2
writeFadeRGB	KEYWORD2
writeFadeGP	KEYWORD2
writeEEPROM	KEYWORD2
writeGammaRLED	KEYWORD2
writeGammaGLED	KEYWORD2
writeGammaBLED	KEYWORD2
writeGammaGP1	KEYWORD2
writeGammaGP2	KEYWORD2
writeGammaGP3	KEYWORD2
readIDCode	KEYWORD2
readVersion	KEYWORD2
ChangeI2CAddress	KEYWORD2

#######################################
# Constants (LITERAL1)
#######################################

onButtonRelease	LITERAL1
onButtonPush	LITERAL1
onButtonDoublePush	LITERAL1
onIncrement	LITERAL1
onDecrement	LITERAL1
onChange	LITERAL1
onMax	LITERAL1
onMin	LITERAL1
onMinMax	LITERAL1
onGP1Rise	LITERAL1
onGP1Fall	LITERAL1
onGP2Rise	LITERAL1
onGP2Fall	LITERAL1
onGP3Rise	LITERAL1
onGP3Fall	LITERAL1
onFadeProcess	LITERAL1
onArrowsPush	LITERAL1
onArrowsRelese	LITERAL1
onUpPush	LITERAL1
onUpRelease	LITERAL1
onDownPush	LITERAL1
onDownRelease	LITERAL1
onRightPush	LITERAL1
onRightRelease	LITERAL1
onLeftPush	LITERAL1
onLeftRelease	LITERAL1
onCentralPush	LITERAL1
onCentralRelease	LITERAL1
onCentralDoublePush	LITERAL1
onButtonLongPush	LITERAL1
GP_PWM	LITERAL1
GP_OUT	LITERAL1
GP_AN	LITERAL1
GP_IN	LITERAL1
GP_PULL_EN	LITERAL1
GP_PULL_DI	LITERAL1
GP_INT_DI	LITERAL1
GP_INT_PE	LITERAL1
GP_INT_NE	LITERAL1
GP_INT_BE	LITERAL1
FADE_R	LITERAL1
FADE_G	LITERAL1
FADE_B	LITERAL1
FADES_GP1	LITERAL1
FADES_GP2	LITERAL1
FADES_GP3	LITERAL1
GP1_POS	LITERAL1
GP1_NEG	LITERAL1
GP2_POS	LITERAL1
GP2_NEG	LITERAL1
GP3_POS	LITERAL1
GP3_NEG	LITERAL1
FADE_INT	LITERAL1
PUSHR	LITERAL1
PUSHP	LITERAL1
PUSHD	LITERAL1
RINC	LITERAL1
RDEC	LITERAL1
RMAX	LITERAL1
RMIN	LITERAL1
INT2	LITERAL1
FLOAT_DATA	LITERAL1
INT_DATA	LITERAL1
WRAP_ENABLE	LITERAL1
WRAP_DISABLE	LITERAL1
DIRE_LEFT	LITERAL1
DIRE_RIGHT	LITERAL1
IPUP_DISABLE	LITERAL1
IPUP_ENABLE	LITERAL1
RMOD_X4	LITERAL1
RMOD_X2	LITERAL1
RMOD_X1	LITERAL1
RGB_ENCODER	LITERAL1
STD_ENCODER	LITERAL1
EEPROM_BANK1	LITERAL1
EEPROM_BANK2	LITERAL1
RESET	LITERAL1
GAMMA_OFF	LITERAL1
GAMMA_1	LITERAL1
GAMMA_1_8	LITERAL1
GAMMA_2	LITERAL1
GAMMA_2_2	LITERAL1
GAMMA_2_4	LITERAL1
GAMMA_2_6	LITERAL1
GAMMA_2_8	LITERAL1
CLK_STRECH_ENABLE	LITERAL1
CLK_STRECH_DISABLE	LITERAL1
REL_MODE_ENABLE	LITERAL1
REL_MODE_DISABLE	LITERAL1
REG_IDCODE	LITERAL1
REG_VERSION	LITERAL1
UPR	LITERAL1
UPP	LITERAL1
DNR	LITERAL1
DNP	LITERAL1
RTR	LITERAL1
RTP	LITERAL1
LTR	LITERAL1
LTP	LITERAL1
CTRR	LITERAL1
CTRP	LITERAL1
CTRDP	LITERAL1
RINC	LITERAL1
RDEC	LITERAL1
RMAX	LITERAL1
RMIN	LITERAL1
INT_2	LITERAL1